社員=sh
名前=nam
課ID=kid
社ID=shid
年収=nes
万円=may
円=y
単位=tani
最大=jmax
最小=jmin
平均年収=avnes
組織=sos
課長=kat
東プロジェクト構成員=higp
西プロジェクト構成員=nisp
山本=yam
プロジェクト=pro
平均=avg
課名=kam
構成員=kos
プロジェクト構成員=prok
SELECT=sel
FROM=fr
WHERE=wh
ORDER=or
COUNT=cnt
DISTINCT=dist
GROUP=grp
HAVING=hav
UNION=uni
CROSS=crs
EXCEPT=exc
INTERSECT=ints
EXIST=exi
INSERT=ins
VALUES=val
UPDATE=upd
BETWEEN=bet
NATURAL=nat
N=n
BY=by